{
    "tileset" : "tilesetherbe.png",
    "terrain" : [
    	[4,  4,  4,  4,  4,  4,  4,  4,  26,  27,  28,  29,  30,  4,  4,  4,  4,  4,  4,  4,  4,  4,  4,  4,  4,  4,  4,  4,  4,  4,  4,  4,  4,  4],
		[4,  4,  4,  4,  4,  4,  4,  4,  31,  32,  33,  34,  35,  59,  4,  4,  4,  4,  4,  4,  4,  4,  4,  4,  4,  4,  4,  4,  4,  4,  4,  4,  4,  4],
		[4,  4,  4,  4,  4,  4,  4,  4,  36,  37,  38,  39,  40,  4,  4,  4,  4,  4,  4,  4,  4,  4,  4,  4,  4,  4,  4,  4,  4,  4,  4,  4,  4,  4],
    	[4,  4,  4,  4,  4,  4,  4,  4,  41,  42,  43,  44,  45,  4,  4,  4,  4,  4,  4,  4,  4,  4,  4,  4,  4,  4,  4,  4,  4,  4,  4,  4,  4,  4],
		[4,  4,  4,  4,  4,  4,  4,  4,  46,  47,  48,  49,  50,  4,  4,  4,  4,  4,  4,  4,  4,  4,  4,  4,  4,  4,  4,  4,  4,  4,  4,  4,  4,  4],
    	[4,  4,  4,  4,  4,  4,  4,  4,  51,  52,  53,  54,  55,  4,  4,  4,  4,  4,  4,  4,  4,  4,  4,  4,  4,  4,  4,  4,  4,  4,  4,  4,  4,  4],
		[4,  4,  4,  4,  4,  4,  4,  4,  4,  4,  4,  4,  4,  4,  4,  4,  4,  4,  4,  4,  4,  4,  4,  4,  4,  4,  4,  4,  4,  4,  4,  4,  4,  4],
    	[4,  4,  4,  4,  4,  4,  4,  4,  4,  4,  4,  4,  4,  4,  4,  4,  4,  4,  4,  77,  78,  78,  78,  78,  78,  78,  78,  78,  78,  78,  78,  78,  78,  78],
		[4,  4,  4,  4,  4,  4,  4,  4,  4,  4,  4,  4,  4,  4,  4,  4,  4,  4,  4,  82,  83,  84,  84,  84,  84,  84,  84,  84,  84,  84,  84,  84,  84,  84],
    	[86,  86,  86,  86,  86,  86,  86,  86,  86,  86,  86,  86,  86,  86,  86,  86,  86,  86,  86,  87,  88,  4,  4,  4,  4,  4,  4,  4,  4,  4,  4,  4,  4,  4],
		[91,  91,  91,  91,  91,  91,  91,  91,  91,  91,  91,  91,  91,  91,  91,  91,  91,  91,  91,  92,  88,  4,  4,  4,  4,  4,  4,  4,  4,  1,  2,  3,  3,  3],
    	[4,  4,  4,  4,  4,  4,  4,  4,  4,  4,  4,  4,  4,  4,  4,  4,  4,  4,  4,  97,  88,  4,  4,  4,  4,  4,  4,  4,  4,  6,  7,  7,  7,  7],
		[4,  4,  4,  4,  4,  4,  4,  4,  4,  4,  4,  4,  4,  4,  4,  4,  4,  4,  4,  97,  88,  4,  4,  56,  57,  58,  4,  4,  4,  11,  7,  7,  7,  7],
    	[4,  4,  4,  4,  4,  4,  4,  4,  4,  4,  4,  4,  4,  4,  4,  4,  4,  4,  4,  97,  88,  4,  4,  61,  62,  63,  4,  4,  4,  16,  7,  7,  7,  7],
    	[4,  4,  4,  4,  4,  4,  4,  4,  4,  4,  4,  4,  4,  4,  4,  4,  4,  4,  4,  97,  88,  4,  4,  66,  67,  68,  4,  4,  4,  21,  7,  7,  7,  7],
		[4,  4,  4,  4,  4,  4,  4,  4,  4,  4,  4,  4,  4,  4,  4,  4,  4,  4,  4,  97,  88,  4,  4,  4,  72,  4,  4,  4,  4,  21,  7,  7,  7,  7],
    	[4,  4,  4,  4,  4,  4,  4,  4,  4,  4,  4,  4,  4,  4,  4,  4,  4,  4,  4,  97,  88,  4,  4,  4,  4,  4,  4,  4,  4,  21,  7,  7,  7,  7]
		
	]
}