{
    "tileset" : "tilesetherbe.png",
    "terrain" : [
    	[56 ,  57,  58,  56,  57,  58,  56,  57,  58,  4,  97,  88,  4,  56,  57,  58,  56,  57,  58,  56,  57,  58,  56,  57,  58,  56,  57,  58,  56,  57,  58,  56,  57,  58],
	    [61 ,  62,  63,  61,  62,  63,  61,  62,  63,  4,  97,  88,  4,  61,  62,  63,  61,  62,  63,  61,  62,  63,  61,  62,  63,  61,  62,  63,  61,  62,  63,  61,  62,  63],
		[66 ,  67,  68,  66,  67,  68,  66,  67,  68,  4,  97,  88,  4,  66,  67,  68,  66,  67,  68,  66,  67,  68,  66,  67,  68,  66,  67,  68,  66,  67,  68,  66,  67,  68],
    	[4 ,  72,  4,  4,  72,  4,  4,  72,  4,  4,  97,  88,  4,  4,  72,  4,  4,  72,  4,  4,  72,  4,  4,  72,  4,  4,  72,  4,  4,  72,  4,  4,  72,  4],
		[4 ,  4,  4,  4,  4,  4,  4,  4,  4,  4,  97,  88,  4,  56,  57,  58,  4,  4,  4,  4,  4,  4,  4,  4,  4,  4,  4,  4,  4,  4,  4,  4,  4,  4],
    	[56 ,  57,  58,  56,  57,  58,  56,  57,  58,  4,  97,  88,  4,  61,  62,  63,  4,  4,  4,  4,  4,  4,  4,  4,  4,  4,  4,  4,  4,  4,  4,  4,  4,  4],
		[61 ,  62,  63,  61,  62,  63,  61,  62,  63,  4,  97,  88,  4,  66,  67,  68,  4,  4,  4,  4,  4,  4,  4,  4,  4,  4,  4,  4,  4,  4,  4,  4,  4,  4],
    	[66 ,  67,  68,  66,  67,  68,  66,  67,  68,  4,  97,  88,  4,  4,  72,  4,  4,  4,  4,  4,  4,  4,  4,  4,  4,  4,  4,  4,  4,  4,  4,  4,  4,  4],
    	[4 ,  72,  4,  4,  72,  4,  4,  72,  4,  4,  97,  88,  4,  56,  57,  58,  4,  4,  4,  4,  4,  4,  4,  4,  4,  4,  4,  4,  4,  4,  4,  4,  4,  4],
        [4 ,  4,  4,  4,  4,  4,  4,  4,  4,  4,  97,  88,  4,  61,  62,  63,   4,  4,  4,  4,  4,  4,  4,  4,  4,  4,  4,  4,  4,  4,  4,  4,  4,  4],
		[4 ,  4,  4,  4,  4,  4,  4,  4,  4,  4,  82,  88,  4,  66,  67,  68,  4,  4,  4,  4,  4,  4,  4,  4,  4,  4,  4,  4,  4,  4,  4,  4,  4,  4],
    	[86 ,  86,  86,  86,  86,  86,  86,  86,  86,  86,  87,  88,  4,  4,  72,  4,  4,  4,  4,  4,  4,  4,  4,  4,  4,  4,  4,  4,  4,  4,  4,  4,  4,  4],
    	[91 ,  91,  91,  91,  91,  91,  91,  91,  91,  91,  91,  88,  4,  56,  57,  58,  4,  4,  4,  4,  4,  4,  4,  4,  4,  4,  4,  4,  4,  4,  4,  4,  4,  4],
        [56 ,  57,  58,  56,  57,  58,  56,  57,  58,  4,  4,  4,  4,  61,  62,  63,  4,  4,  4,  4,  4,  4,  4,  4,  4,  4,  4,  4,  4,  4,  4,  4,  4,  4],
		[61 ,  62,  63,  61,  62,  63,  61,  62,  63,  4,  4,  4,  4,  66,  67,  68,  4,  4,  4,  4,  4,  4,  4,  4,  4,  4,  4,  4,  4,  4,  4,  4,  4,  4],
    	[66 ,  67,  68,  66,  67,  68,  66,  67,  68,  4,  4,  4,  4,  4,  72,  4,  4,  4,  4,  4,  4,  4,  4,  4,  4,  4,  4,  4,  4,  4,  4,  4,  4,  4],
    	[4 ,  72,  4,  4,  72,  4,  4,  72,  4,  4,  4,  4,  4,  4,  4,  4,  4,  4,  4,  4,  4,  4,  4,  4,  4,  4,  4,  4,  4,  4,  4,  4,  4,  4]
		
	]
}
